0000000000000000
0000000000000000
0000000000000000
1111100001111100
1200100001000111
1030100001010041
1033100001011411
1110100001010410
0010111111010010
1110000000000010
1000011111111110
1000010000000000
1111110000000000
0000000000000000
0000000000000000
0000000000000000