11111111
11411411
11302301
14300031
11311141
11410111
11110000