1111111111
1111001021
1110001001
1113030301
1110311001
1110301011
1444440011
1111111111