11111111
11200011
11030011
14101011
14131001
14300101
14000301
11111111