111111111111
110011111111
100311110001
103011113001
100344444031
110000102011
111111111111