000111111111111111
111100000000000001
100000000411111001
100010100100000011
100010100100100011
100110111100101401
101100000030100101
140110000000100101
100011111033000101
110000000030100001
010111111110111111
010000000010100000
010000000010100000
010000011140111111
010000000000000001
111111111100000021
000000000111111111
000000000000000000