11111
10201
10001
10301
10001
10001
10001
10401
10001
11111